width=10^
height=8^
levelID=0^
tiles=0019001900190019001900190019001900190019
0019000300030003000300030003000300030019
0019001700050017000500170022001700170019
0019001700050017000500170017000100170019
0019001700050005000500170022000100170019
0019000100050017000500170022001700170019
0019003500350035003500350035003500350019
0019001900190019001900190019001900190019^
enterTile=1:2^