width=10^
height=8^
levelID=0^
tiles=0019000500050005000500050005000500050019
0020001700170001000100170017001700010018
0020001700220017002200170022001700170018
0020001700220017002200170017000100170018
0020001700220022002200170022000100170018
0020000100220017002200170022001700170018
0020000100170017001700170017001700170018
0019002200220022002200220022002200220019^
enterTile=1:1^