width=10^
height=8^
levelID=0^
tiles=0019003500350035003500350035003500350019
0020000100170017001700170017001700010018
0020000100170017001700010001001700170018
0020000100170001000100010001001700170018
0020000100170001000100170001001700170018
0020000100010001000100010001001700170018
0020001700170017001700170017001700170018
0019000300030003000300030003000300030019^