0019001900190019001900190019001900190019
0019000300030003000300030003000300030019
0019001700050017000500170022001700170019
0019001700050017000500170017000100170019
0019001700050005000500170022000100170019
0019000100050017000500170022001700170019
0019003500350035003500350035003500350019
0019001900190019001900190019001900190019
texture[1616]=C:\Users\User\Documents\GitHub\Export\android\assets\game_textures.png