00310031003100310031003100310031
00000000000000000000000000000000
00000000000000000000000000000000
00000000000000000000000000000000
00000000000000000000000000000000
00320032003200320032003200320032
texture[1616]=C:\Users\Toby\Documents\GitHub\Export\android\assets\game_textures.png