00220001000100010001000500050005
00220005000500050005000500220005
00220005000500050005000100220005
00010022002200220005002200220005
00010001000100220022002200220005
00220022000100010001000100220005
texture[1616]=C:\Users\Toby\Documents\GitHub\Export\android\assets\game_textures.png